//MAP CONVERTED BY dmm2tgm.py THIS HEADER COMMENT PREVENTS RECONVERSION, DO NOT REMOVE
"a" = (
/turf/open/space/basic,
/area/space)
"b" = (
/turf/open/gm/dirtgrassborder/south,
/area/space)
"c" = (
/turf/open/gm/dirtgrassborder/north,
/area/space)
"d" = (
/obj/structure/surface/table/reinforced/prison{
	color = "#6b675e"
	},
/turf/open/floor/corsat{
	dir = 1;
	icon_state = "squareswood"
	},
/area/space)
"e" = (
/obj/structure/barricade/handrail/strata{
	dir = 4
	},
/obj/structure/barricade/handrail/strata,
/turf/open/gm/dirtgrassborder/grassdirt_corner/south_east,
/area/space)
"f" = (
/obj/structure/barricade/handrail/strata,
/obj/structure/barricade/handrail/strata{
	dir = 8
	},
/turf/open/gm/dirtgrassborder/weedable{
	icon_state = "grass1"
	},
/area/space)
"h" = (
/obj/structure/barricade/handrail/strata{
	dir = 8
	},
/obj/structure/barricade/handrail/strata{
	dir = 1
	},
/turf/open/gm/dirtgrassborder/grassdirt_corner/north_west,
/area/space)
"i" = (
/obj/structure/barricade/handrail/strata{
	dir = 4
	},
/turf/open/gm/dirtgrassborder/east,
/area/space)
"j" = (
/obj/structure/surface/table/reinforced/prison{
	color = "#6b675e"
	},
/obj/structure/machinery/door/window/southright{
	dir = 4
	},
/turf/open/floor/corsat{
	dir = 1;
	icon_state = "squareswood"
	},
/area/space)
"k" = (
/obj/structure/surface/table/reinforced,
/turf/open/floor/strata{
	color = "#5e5d5d";
	dir = 10;
	icon_state = "multi_tiles"
	},
/area/space)
"l" = (
/turf/closed/wall/cult{
	hull = 1;
	name = "runed hull"
	},
/area/space)
"m" = (
/obj/structure/stairs/perspective/kutjevo{
	dir = 1
	},
/turf/open/floor/holofloor{
	dir = 2;
	icon_state = "cult"
	},
/area/space)
"n" = (
/obj/structure/barricade/handrail/strata{
	dir = 1
	},
/obj/structure/barricade/handrail/strata{
	dir = 8
	},
/turf/open/gm/dirtgrassborder/weedable{
	icon_state = "grass1"
	},
/area/space)
"o" = (
/obj/structure/machinery/prop/yautja/bubbler,
/turf/open/floor/corsat{
	dir = 1;
	icon_state = "squareswood"
	},
/area/space)
"p" = (
/obj/structure/surface/table/reinforced/prison,
/obj/structure/window/reinforced{
	dir = 4;
	health = 80
	},
/obj/structure/machinery/door/window/southright,
/obj/item/clothing/suit/armor/yautja/thrall,
/obj/item/clothing/mask/gas/yautja/thrall,
/obj/item/clothing/shoes/yautja/thrall,
/obj/item/clothing/under/chainshirt/thrall,
/turf/open/floor/sandstone/runed,
/area/space)
"q" = (
/obj/structure/closet/coffin/predator,
/turf/open/floor/corsat{
	dir = 1;
	icon_state = "squareswood"
	},
/area/space)
"r" = (
/obj/structure/machinery/prop/almayer/CICmap/yautja,
/turf/open/floor/strata{
	color = "#5e5d5d";
	dir = 10;
	icon_state = "multi_tiles"
	},
/area/space)
"s" = (
/obj/structure/bed/alien,
/turf/open/floor/holofloor{
	dir = 2;
	icon_state = "cult"
	},
/area/space)
"t" = (
/obj/structure/barricade/handrail/strata{
	dir = 1
	},
/turf/open/gm/dirtgrassborder/weedable{
	icon_state = "grass1"
	},
/area/space)
"u" = (
/obj/structure/machinery/door/window/eastleft,
/obj/structure/machinery/door/window/eastleft{
	dir = 8
	},
/turf/open/floor/holofloor{
	dir = 2;
	icon_state = "cult"
	},
/area/space)
"v" = (
/turf/open/gm/dirtgrassborder{
	icon_state = "desert3"
	},
/area/space)
"w" = (
/obj/structure/surface/rack{
	color = "#6b675e";
	layer = 2.79
	},
/obj/item/weapon/yautja/knife,
/obj/item/reagent_container/hypospray/autoinjector/yautja,
/obj/item/reagent_container/hypospray/autoinjector/yautja,
/turf/open/floor/corsat{
	dir = 1;
	icon_state = "squareswood"
	},
/area/space)
"x" = (
/obj/structure/barricade/handrail/strata{
	dir = 1
	},
/obj/structure/barricade/handrail/strata{
	dir = 4
	},
/turf/open/gm/dirtgrassborder/grassdirt_corner/north_east,
/area/space)
"y" = (
/obj/effect/alien/egg,
/turf/open/floor/holofloor{
	dir = 2;
	icon_state = "cult"
	},
/area/space)
"z" = (
/obj/structure/surface/rack{
	color = "#6b675e";
	layer = 2.79
	},
/obj/item/weapon/harpoon/yautja,
/obj/item/weapon/harpoon/yautja,
/obj/item/weapon/harpoon/yautja,
/obj/item/weapon/harpoon/yautja,
/turf/open/floor/corsat{
	dir = 1;
	icon_state = "squareswood"
	},
/area/space)
"B" = (
/obj/structure/xenoautopsy/tank/alien,
/turf/open/floor/corsat{
	dir = 1;
	icon_state = "squareswood"
	},
/area/space)
"C" = (
/obj/structure/machinery/door/window/northright,
/obj/structure/machinery/door/window/southright,
/turf/open/floor/holofloor{
	dir = 2;
	icon_state = "cult"
	},
/area/space)
"D" = (
/turf/open/floor/strata{
	color = "#5e5d5d";
	dir = 10;
	icon_state = "multi_tiles"
	},
/area/space)
"E" = (
/obj/structure/showcase{
	desc = "An ancient, dusty tomb with strange alien writing. It's best not to touch it.";
	icon_state = "yaut";
	name = "alien sarcophagus";
	dir = 1
	},
/turf/open/floor/strata{
	color = "#5e5d5d";
	dir = 10;
	icon_state = "multi_tiles"
	},
/area/space)
"F" = (
/obj/structure/barricade/handrail/strata,
/turf/open/gm/dirtgrassborder/weedable{
	icon_state = "grass1"
	},
/area/space)
"H" = (
/obj/structure/showcase{
	desc = "An ancient, dusty tomb with strange alien writing. It's best not to touch it.";
	icon_state = "yaut";
	name = "alien sarcophagus"
	},
/obj/item/clothing/mask/gas/yautja/hunter{
	anchored = 1;
	pixel_y = 20
	},
/turf/open/floor/corsat{
	dir = 1;
	icon_state = "squareswood"
	},
/area/space)
"I" = (
/turf/open/gm/dirtgrassborder{
	icon_state = "desert2"
	},
/area/space)
"K" = (
/turf/closed/wall/huntership,
/area/space)
"L" = (
/turf/open/gm/dirtgrassborder{
	icon_state = "desert0"
	},
/area/space)
"M" = (
/turf/open/floor/holofloor{
	dir = 2;
	icon_state = "cult"
	},
/area/space)
"N" = (
/obj/structure/barricade/handrail/strata{
	dir = 8
	},
/turf/open/gm/dirtgrassborder/west,
/area/space)
"O" = (
/obj/structure/surface/rack{
	color = "#6b675e";
	layer = 2.79
	},
/obj/item/stack/yautja_rope,
/obj/item/stack/yautja_rope,
/obj/item/stack/yautja_rope,
/turf/open/floor/corsat{
	dir = 1;
	icon_state = "squareswood"
	},
/area/space)
"P" = (
/turf/open/gm/dirtgrassborder{
	icon_state = "desert_dug"
	},
/area/space)
"Q" = (
/obj/structure/barricade/handrail/strata{
	dir = 8
	},
/obj/structure/barricade/handrail/strata,
/turf/open/gm/dirtgrassborder/grassdirt_corner/south_west,
/area/space)
"S" = (
/obj/structure/barricade/handrail/strata{
	dir = 1
	},
/obj/structure/barricade/handrail/strata{
	dir = 4
	},
/turf/open/gm/dirtgrassborder/weedable{
	icon_state = "grass1"
	},
/area/space)
"T" = (
/obj/structure/prop/brazier/torch{
	pixel_y = -2
	},
/turf/closed/wall/mineral/sandstone/runed,
/area/space)
"U" = (
/turf/open/gm/dirtgrassborder{
	icon_state = "desert"
	},
/area/space)
"V" = (
/turf/open/shuttle/predship,
/area/space)
"W" = (
/obj/structure/xenoautopsy/tank/hugger,
/turf/open/floor/corsat{
	dir = 1;
	icon_state = "squareswood"
	},
/area/space)
"X" = (
/obj/structure/surface/table/reinforced/prison{
	color = "#6b675e"
	},
/obj/structure/window/reinforced{
	dir = 4;
	health = 80
	},
/obj/structure/window/reinforced{
	dir = 8;
	health = 80
	},
/obj/item/reagent_container/glass/rag/polishing_rag,
/obj/item/reagent_container/glass/rag/polishing_rag{
	pixel_x = 9
	},
/obj/item/reagent_container/glass/rag/polishing_rag{
	pixel_x = 4;
	pixel_y = 3
	},
/turf/open/floor/corsat{
	dir = 1;
	icon_state = "squareswood"
	},
/area/space)
"Y" = (
/turf/open/gm/dirtgrassborder{
	icon_state = "desert1"
	},
/area/space)
"Z" = (
/obj/structure/barricade/handrail/strata,
/obj/structure/barricade/handrail/strata{
	dir = 4
	},
/turf/open/gm/dirtgrassborder/weedable{
	icon_state = "grass1"
	},
/area/space)

(1,1,1) = {"
a
a
a
a
a
a
a
a
a
a
a
a
a
a
a
a
a
a
a
a
a
a
a
a
a
a
a
a
a
a
a
a
a
a
a
a
a
a
a
a
a
a
a
a
a
a
a
a
a
a
"}
(2,1,1) = {"
a
a
a
a
a
a
a
a
a
a
a
a
a
a
a
a
a
a
a
K
K
K
K
K
K
K
a
a
a
a
a
a
a
a
a
a
a
a
a
a
a
a
a
a
a
a
a
a
a
a
"}
(3,1,1) = {"
a
a
a
a
a
a
a
a
a
a
a
a
a
a
a
a
a
a
K
K
y
K
y
K
y
K
K
a
a
a
a
a
a
a
a
a
a
a
a
a
a
a
a
a
a
a
a
a
a
a
"}
(4,1,1) = {"
a
a
a
a
a
a
a
a
a
a
a
a
a
a
a
a
a
a
K
K
u
l
u
l
u
K
K
a
a
a
a
a
a
a
a
a
a
a
a
a
a
a
a
a
a
a
a
a
a
a
"}
(5,1,1) = {"
a
a
a
a
a
a
a
a
a
a
a
a
a
a
a
a
a
K
K
K
V
V
V
V
V
l
K
K
a
a
a
a
a
a
a
a
a
a
a
a
a
a
a
a
a
a
a
a
a
a
"}
(6,1,1) = {"
a
a
a
a
a
a
a
a
a
a
a
a
a
a
a
a
a
K
y
C
V
M
M
M
V
C
y
K
a
a
a
a
a
a
a
a
a
a
a
a
a
a
a
a
a
a
a
a
a
a
"}
(7,1,1) = {"
a
a
a
a
a
a
a
a
a
a
a
a
a
a
a
a
a
K
K
l
V
M
M
M
V
l
K
K
a
a
a
a
a
a
a
a
a
a
a
a
a
a
a
a
a
a
a
a
a
a
"}
(8,1,1) = {"
a
a
a
a
a
a
a
a
a
K
K
K
K
K
a
a
a
K
y
C
V
M
M
M
V
C
y
K
a
a
a
K
K
K
K
K
a
a
a
a
a
a
a
a
a
a
a
a
a
a
"}
(9,1,1) = {"
a
a
a
a
a
a
a
a
K
K
j
K
j
K
K
a
a
K
K
l
V
M
M
M
V
l
K
K
a
a
K
K
j
K
j
K
K
a
a
a
a
a
a
a
a
a
a
a
a
a
"}
(10,1,1) = {"
a
a
a
a
a
a
a
K
K
M
M
K
M
M
K
K
a
K
y
C
V
V
M
V
V
C
y
K
a
K
K
M
M
K
M
M
K
K
a
a
a
a
a
a
a
a
a
a
a
a
"}
(11,1,1) = {"
a
a
a
a
a
a
a
K
s
M
M
K
M
M
s
K
a
K
K
K
V
V
M
V
V
K
K
K
a
K
s
M
M
K
M
M
s
K
a
a
a
a
a
a
a
a
a
a
a
a
"}
(12,1,1) = {"
a
a
a
a
a
a
a
K
d
M
M
K
M
M
d
K
a
K
W
V
V
V
M
V
V
V
B
K
a
K
d
M
M
K
M
M
d
K
a
a
a
a
a
a
a
a
a
a
a
a
"}
(13,1,1) = {"
a
a
a
a
a
a
a
K
d
M
M
K
M
M
d
K
a
K
W
V
V
V
M
V
V
V
B
K
a
K
d
M
M
K
M
M
d
K
a
a
a
a
a
a
a
a
a
a
a
a
"}
(14,1,1) = {"
a
a
a
a
a
K
K
K
K
K
D
K
D
K
K
K
K
K
K
K
K
K
D
K
K
K
K
K
K
K
K
K
D
K
D
K
K
K
K
K
a
a
a
a
a
a
a
a
a
a
"}
(15,1,1) = {"
a
a
a
a
K
K
D
D
D
K
D
D
D
D
D
K
D
D
D
D
D
D
D
D
D
D
D
D
D
K
D
D
D
D
D
K
z
z
z
K
K
a
a
a
a
a
a
a
a
a
"}
(16,1,1) = {"
a
a
a
a
K
D
D
M
K
K
K
M
M
M
M
M
M
M
M
M
M
M
M
M
M
M
M
M
M
M
M
M
M
K
K
K
M
M
M
O
K
a
a
a
a
a
a
a
a
a
"}
(17,1,1) = {"
a
a
a
a
K
D
M
M
M
M
M
M
M
M
M
M
M
M
M
M
M
M
M
M
M
M
M
M
M
M
M
M
M
M
M
M
M
M
M
O
K
a
a
a
a
a
a
a
a
a
"}
(18,1,1) = {"
a
a
a
a
K
D
M
V
V
M
K
M
D
D
D
K
D
D
D
D
D
D
D
D
D
D
D
D
D
K
D
D
D
K
M
M
M
M
M
w
K
a
a
a
a
a
a
a
a
a
"}
(19,1,1) = {"
a
a
a
a
K
D
M
V
V
M
K
o
X
K
K
K
K
K
K
K
K
K
D
K
K
K
K
K
K
K
K
K
D
K
D
M
M
M
M
D
K
a
a
a
a
a
a
a
a
a
"}
(20,1,1) = {"
a
a
a
a
K
D
M
V
V
M
K
K
K
K
a
K
D
D
D
D
D
D
D
D
D
D
D
D
D
K
a
K
K
K
p
m
M
M
M
D
K
a
a
a
a
a
a
a
a
a
"}
(21,1,1) = {"
a
a
a
a
K
D
M
V
V
M
D
K
a
a
a
K
D
M
M
M
M
M
M
M
M
M
M
M
D
K
a
a
a
K
p
m
M
M
M
D
K
a
a
a
a
a
a
a
a
a
"}
(22,1,1) = {"
a
a
a
a
K
D
M
V
V
M
D
K
a
a
K
K
D
M
M
M
M
M
M
M
M
M
M
M
D
K
K
a
a
K
p
m
M
M
M
D
K
a
a
a
a
a
a
a
a
a
"}
(23,1,1) = {"
a
a
a
a
K
D
M
V
V
M
D
K
a
a
K
D
D
M
M
V
V
V
V
V
V
V
M
M
D
D
K
a
a
K
p
m
M
M
M
D
K
a
a
a
a
a
a
a
a
a
"}
(24,1,1) = {"
a
a
a
a
K
D
M
V
V
M
D
K
a
a
K
D
M
M
V
V
h
N
N
N
Q
V
V
M
M
D
K
a
a
K
D
M
M
M
M
D
K
a
a
a
a
a
a
a
a
a
"}
(25,1,1) = {"
a
a
a
a
K
D
M
V
V
M
D
K
a
a
K
D
M
M
V
n
c
v
U
I
b
f
V
M
M
D
K
a
a
K
K
M
K
K
M
K
K
a
a
a
a
a
a
a
a
a
"}
(26,1,1) = {"
a
a
a
a
K
D
M
V
V
M
D
K
a
a
K
D
M
M
V
t
c
U
P
U
b
F
V
M
M
D
K
a
a
K
H
M
M
M
M
E
K
a
a
a
a
a
a
a
a
a
"}
(27,1,1) = {"
a
a
a
a
K
D
M
V
V
M
D
K
a
a
K
D
M
M
V
S
c
Y
U
L
b
Z
V
M
M
D
K
a
a
K
D
M
M
M
M
D
K
a
a
a
a
a
a
a
a
a
"}
(28,1,1) = {"
a
a
a
a
K
D
M
V
V
M
D
K
a
a
K
D
M
M
V
V
x
i
i
i
e
V
V
M
M
D
K
a
a
K
H
M
M
M
M
E
K
a
a
a
a
a
a
a
a
a
"}
(29,1,1) = {"
a
a
a
a
K
D
M
V
V
M
D
K
a
a
K
D
D
M
M
V
V
V
V
V
V
V
M
M
D
D
K
a
a
K
D
M
M
M
M
D
K
a
a
a
a
a
a
a
a
a
"}
(30,1,1) = {"
a
a
a
a
K
T
M
M
M
M
T
K
a
a
K
K
D
M
M
M
M
M
M
M
M
M
M
M
D
K
K
a
a
K
H
M
M
M
M
E
K
a
a
a
a
a
a
a
a
a
"}
(31,1,1) = {"
a
a
a
a
K
D
M
M
M
D
D
K
a
a
a
K
D
D
M
M
M
M
M
M
M
M
M
D
D
K
a
a
a
K
D
D
M
M
D
D
K
a
a
a
a
a
a
a
a
a
"}
(32,1,1) = {"
a
a
a
a
K
K
D
M
M
D
K
K
a
a
a
K
K
D
D
D
D
D
D
D
D
D
D
D
K
K
a
a
a
K
K
D
M
M
D
K
K
a
a
a
a
a
a
a
a
a
"}
(33,1,1) = {"
a
a
a
a
a
K
D
D
D
D
K
a
a
a
a
a
K
K
K
D
K
K
K
K
K
D
K
K
K
a
a
a
a
a
K
q
K
K
q
K
a
a
a
a
a
a
a
a
a
a
"}
(34,1,1) = {"
a
a
a
a
a
K
K
D
D
K
K
a
a
a
a
K
K
k
D
D
D
k
k
k
D
D
D
k
K
K
a
a
a
a
K
K
K
K
K
K
a
a
a
a
a
a
a
a
a
a
"}
(35,1,1) = {"
a
a
a
a
a
a
K
K
K
K
a
a
a
a
a
K
k
D
M
M
M
M
M
M
M
M
M
D
k
K
a
a
a
a
a
K
K
K
K
a
a
a
a
a
a
a
a
a
a
a
"}
(36,1,1) = {"
a
a
a
a
a
a
a
a
a
a
a
a
a
a
a
K
D
M
M
M
M
M
M
M
M
M
M
M
D
K
a
a
a
a
a
a
a
a
a
a
a
a
a
a
a
a
a
a
a
a
"}
(37,1,1) = {"
a
a
a
a
a
a
a
a
a
a
a
a
a
a
a
K
k
M
M
M
M
D
k
D
M
M
M
M
k
K
a
a
a
a
a
a
a
a
a
a
a
a
a
a
a
a
a
a
a
a
"}
(38,1,1) = {"
a
a
a
a
a
a
a
a
a
a
a
a
a
a
a
K
k
M
M
M
M
D
k
D
M
M
M
M
k
K
a
a
a
a
a
a
a
a
a
a
a
a
a
a
a
a
a
a
a
a
"}
(39,1,1) = {"
a
a
a
a
a
a
a
a
a
a
a
a
a
a
a
K
D
M
M
M
M
M
M
M
M
M
M
M
D
K
a
a
a
a
a
a
a
a
a
a
a
a
a
a
a
a
a
a
a
a
"}
(40,1,1) = {"
a
a
a
a
a
a
a
a
a
a
a
a
a
a
a
K
k
D
M
M
M
M
M
M
M
M
M
D
k
K
a
a
a
a
a
a
a
a
a
a
a
a
a
a
a
a
a
a
a
a
"}
(41,1,1) = {"
a
a
a
a
a
a
a
a
a
a
a
a
a
a
a
K
K
k
D
k
k
D
D
D
k
k
D
k
K
K
a
a
a
a
a
a
a
a
a
a
a
a
a
a
a
a
a
a
a
a
"}
(42,1,1) = {"
a
a
a
a
a
a
a
a
a
a
a
a
a
a
a
a
K
K
K
K
K
K
D
K
K
K
K
K
K
a
a
a
a
a
a
a
a
a
a
a
a
a
a
a
a
a
a
a
a
a
"}
(43,1,1) = {"
a
a
a
a
a
a
a
a
a
a
a
a
a
a
a
a
a
K
D
D
D
D
D
D
M
M
D
K
a
a
a
a
a
a
a
a
a
a
a
a
a
a
a
a
a
a
a
a
a
a
"}
(44,1,1) = {"
a
a
a
a
a
a
a
a
a
a
a
a
a
a
a
a
a
K
D
D
M
M
M
M
M
D
D
K
a
a
a
a
a
a
a
a
a
a
a
a
a
a
a
a
a
a
a
a
a
a
"}
(45,1,1) = {"
a
a
a
a
a
a
a
a
a
a
a
a
a
a
a
a
a
K
K
D
M
M
M
M
M
D
K
K
a
a
a
a
a
a
a
a
a
a
a
a
a
a
a
a
a
a
a
a
a
a
"}
(46,1,1) = {"
a
a
a
a
a
a
a
a
a
a
a
a
a
a
a
a
a
a
K
D
D
D
r
D
D
D
K
a
a
a
a
a
a
a
a
a
a
a
a
a
a
a
a
a
a
a
a
a
a
a
"}
(47,1,1) = {"
a
a
a
a
a
a
a
a
a
a
a
a
a
a
a
a
a
a
K
K
D
D
D
D
D
K
K
a
a
a
a
a
a
a
a
a
a
a
a
a
a
a
a
a
a
a
a
a
a
a
"}
(48,1,1) = {"
a
a
a
a
a
a
a
a
a
a
a
a
a
a
a
a
a
a
a
K
l
l
l
l
l
K
a
a
a
a
a
a
a
a
a
a
a
a
a
a
a
a
a
a
a
a
a
a
a
a
"}
(49,1,1) = {"
a
a
a
a
a
a
a
a
a
a
a
a
a
a
a
a
a
a
a
a
a
a
a
a
a
a
a
a
a
a
a
a
a
a
a
a
a
a
a
a
a
a
a
a
a
a
a
a
a
a
"}
(50,1,1) = {"
a
a
a
a
a
a
a
a
a
a
a
a
a
a
a
a
a
a
a
a
a
a
a
a
a
a
a
a
a
a
a
a
a
a
a
a
a
a
a
a
a
a
a
a
a
a
a
a
a
a
"}
